-----------
|         |
|         |
|         |
|         |
|         |
|         |
- ---------
| |        
| |        
| |        
| |        
| |        
| |        
- ---------
|         |
|         |
|         |
|         |
|         |
|         |
-----------

